WWWWWWWWWWWWWWWWWWWWWWWWWWWW
WOOOOOOOOOOOOOOOOOOOOOOOOOOW
WOWWWWOWWWOWWWWWWOWWWOWWWWOW
WDWWWWOWWWOWWWWWWOWWWOWWWWDW
WOWWWWOWWWOWWWWWWOWWWOWWWWOW
WOWWWWOOOOOOOOOOOOOOOOWWWWOW
WOWWWWOWWWWWWWWWWWWWWOWWWWOW
WOWWWWOWWWWWWWWWWWWWWOWWWWOW
WOOOOOOWWOOOOOOOOOOWWOOOOOOW
WWWWWWOWWxWWWWWWWWxWWOWWWWWW
WWWWWWOWWxWWWWWWWWxWWOWWWWWW
WWWWWWOxxxxxxxxxxxxxxOWWWWWW
WWWWWWOWWxWW====WWxWWOWWWWWW
WWWWWWOWWxWGGGGGGWxWWOWWWWWW
TOOOOOOWWxWGGGGGGWxWWOOOOOOT
WWWWWWOWWxWGGGGGGWxWWOWWWWWW
WWWWWWOWWxWWWWWWWWxWWOWWWWWW
WWWWWWOxxxxxxxxxxxxxxOWWWWWW
WWWWWWOWWWWWxWWxWWWWWOWWWWWW
WWWWWWOWWWWWxWWxWWWWWOWWWWWW
WDOOOOOOOOOOOWWOOOOOOOOOOODW
WWWOWWOWWWWWOWWOWWWWWOWWOWWW
WWWOWWOWWWWWOWWOWWWWWOWWOWWW
WOOOWWOOOOWWOPPOWWOOOOWWOOOW
WOWWWWOWWOWWWWWWWWOWWOWWWWOW
WOWWWWOWWOWWWWWWWWOWWOWWWWOW
WOWWOOOOOOOOOOOOOOOOOOOOWWOW
WOWWOWWWWWWWWWWWWWWWWWWOWWOW
WOWWOWWWWWWWWWWWWWWWWWWOWWOW
WOOOOOOOOOOOOOOOOOOOOOOOOOOW
WWWWWWWWWWWWWWWWWWWWWWWWWWWW
